NO ./textures/dir/north.xpm
SO ./textures/dir/south.xpm
EA ./textures/dir/east.xpm
WE ./textures/dir/west.xpm
C 100,200,200

         F      158,        158,         158						

                              11111111111
111          1111             10000000001
101          1001             10W00100001
111          1111             10000000001
                              11111111111