NO ./textures/xpm/bg.xpm
SO ./textures/xpm/banane.xpm
WE ./textures/xpm/oui.xpm
EA ./textures/xpm/bookshelf.xpm
C 83,24,135
F 220,100,0

11111111111
10000000001
10P00000001
10000000001
11111111111