NO 4@./textures/xpm/dirt.xpm

C 100,200,200
WE ./textures/xpm/banane.xpm


F 100  , 70 ,50
SO 4@./textures/xpm/dirt.xpm

EA 4@./textures/xpm/dirt.xpm

        1111111111111111111111111
        1000000000110000000000001
        1011000001110000000000001
        1001000000000000000000001
111111111011000001110000000000001
10000000001100000111011111111111111111111111111
11110111111111011100000010001    10000001000001111
111101111111110111010100100011111100000010000000011111111111
110000001101010111000000100000000000000010000000000000000001
1000000000000000CC000000C00011111100000010000000000000000001
10000000000000001101010010001    100000010000000000000000001
1100000111010101111101111E001    111011111000111111111111111
11110111 1110101 101111010001      1C1    1C1
11111111 1111111 111111111111      101    101111111111111
                                   101    100000000000001
    111111111111111111111111111111110111111111111111111C11111
    100000000000000000000000000000000000000000000000000000001
    100000000000000000000000000000000000000000000000000000001
    111111111111111111111111111111110111111111111111111111111
    100000000000000000000000000000000000000000000000000000001
    100000000000000000000000000000000000000000000000000000001
    100000000000000000000000000000000000000000000000000000001
    111111111111111111111111111111111111111111111111111111111