NO ./textures/xpm/banane.xpm

C 225,30,0 
WE ./textures/xpm/leaves.xpm



F 220  , 100 ,100
SO ./textures/xpm/bookshelf.xpm

EA ./textures/xpm/bookshelf.xpm

        1111111111111111111111111
        1000000000110000000000001
        1011000001110000000000001
        1001000000000000000000001
111111111011000001110000000000001
100000000011000001110111111111111
11110111111111011100000010001
11110111111111011101010010001
11000000110101011100000010001
1000000000000000CC000000C0001
10000000000000001101010010001
1100000111010101111101111N001
11110111 1110101 101111010001
11111111 1111111 11111111111