NO ./textures/xpm/banane.xpm

C 100,200,200
WE ./textures/xpm/leaves.xpm



F 100  , 70 ,50
SO ./textures/xpm/bookshelf.xpm

EA ./textures/xpm/bookshelf.xpm

        1111111111111111111111111
        1000000000110000000000001
        1011000001110000000000001
        1001000000000000000000001
111111111011000001110000000000001
10000000001100000111011111111111111111111
11110111111111011100000010001    10000001
11110111111111011101010010001111110000001
11000000110101011100000010000000000000001
1000000000000000CC000000C0001111110000001
10000000000000001101010010001    10000001
1100000111010101111101111E001    11111111
11110111 1110101 101111010001
11111111 1111111 11111111111